OOOOOOOOOOOOOOOOOOOOOOOOO
O         O     O   O   O
OOOOO OOO O OOO O O O O O
O     O O O   O O O O O O
O OOOOO O OOO O O O OOO O
O O     O     O   O     O
O O OOOOOOOOOOOOOOOOOOO O
O O O       O         O O
OOO O OOO O O OOOOOOO O O
O   O   O O   O       O O
OOO OOO O OOOOO OOOOOOO O
O     O O O   O O   O   O
O OOOOO O O O OOO O O OOO
O       O   O     O     O
OOOOOOOOOOOOOUOOOOOOOOOOO